...###
..##.#.####
.##..###..#
##...G....#
#...R..#..#
###..gg#..#
..#..#....#
.##.##.#.##
.#......##
.#.....##
.#rr####